R 720 320




NO ./textures/N1.xpm
SO ./textures/S1.xpm
EA ./textures/E1.xpm
WE ./textures/W1.xpm

C    122,124,0
F    212,48,34

11111111111111111111
10000000000000000001
10000000000000000001
100000000N0000000001
10000000000000000001
10000000000000000001
10000000000000000001
11111111111111111111
