R 1200 720




NO ./textures/N.xpm
EA ./textures/E.xpm
SO ./textures/S.xpm
WE ./textures/W.xpm

C    122,124,0
F    212,48,34


        1111111111111111111111111
        10000000001100000000000011
        100110000011100000000000011
        10010000000000000000000011
111111111011000001110000000000001
100000000011000001110111110111111
11110111111111011100000010001
11110111111111011101010010001
11000000110101011100000000001
10000S00000000001100000010001
10000000000000001101010010001
1100000111010101111101111000111
11111111 1110101 101111010001
11111111 1111111 111111111111